           ^        ###         
           ^^        ##         
         ^^^^^^^     ## #       
   ^ ^^  ^^^^^^    # ###        
   ^^ ^    ^ ^      # ###       
    ^^^^     ^^       #         
    ^^^                         
  ^^^^                          
   ^  ^                         
       ^                        
          ^                     
          ^^                    
        ^^^^^                   
         ^^^^         ^ ^   ^^  
      *^^^^^         ^^^^^ ^^^^ 
       ^^^       ^     ^^^^^^^^^
               ^^*^ ^^^^^^^^^^^ 
                 ^^^^^^ ^^^ ^^^ 
                  ^^      ^  ^  
        ^  ^ ^    ^^         ^  
   ^^   ^^^ ^^     ^^           
  ^^^^^ ^^^ ^^^   ^ ^           
 ^^^^^^  ^^^^           ##~     
^^ ^^ ^   ^^      ^ ^ ~###      
     ^^          ^^^  ####~     
                  ^^^####       
         ^        ^^^^##        
       ^^      ##^^^^           
       ^^^^^  ## ^^  ^          
      ^^^^^^ ##    ^            
        ^^^ ###                 
        ^^^  #                  

