                                
                                
                                
                         ^ *    
                          ^^^   
     *^^*        ~~#~     ^^*^ *
    ^^^^*      ~####      ^^^*^ 
   * ^^ ^       ####~      ^  * 
    ^^ ^ *      ###             
      *                         
           *^^^                 
          ^^^^^*      ^ ^^      
         ^ ^^^*      ^^^^ *     
          ^***       *^^*^      
           ^^^         ^^       
    ~      ^^*                  
 #~~#     **^*                  
 ~###~#~   ^^    ^^             
 #####   *^^^*  *^^             
  #^^~*^*^      **^^            
   *^^^^^        ^^^       *    
  ##**^^         ^^      *^^*   
    #*^          ^     *^^  ^   
    ##~~       *  *     ** ^ ^^ 
    ~##       *^^           ^*^ 
    ~#~##    ^^^^*         *^^* 
       ##    ^*^**        #     
      ^*^    ^  ^       ~#      
      ^^^      *^^     ~##~     
      ^^**       *    ~###~     
      *^^^*           ~####     
        *^^*           # ~      

